The Team Base Camps for the 32 participating teams for the 2014 FIFA World Cup Brazilâ„¢ were announced on 1 February 2014. The teams will be spread into five regions across Brazil.

You can check out the location of your national team's Base Camp in the list below or in the related PDF overview.



Algeria: Sorocaba

Australia, Vitoria



Argentina: Vespasiano



Belgium: Mogi das Cruzes

Bosnia and Herzegowina: Guaruja

Brazil: Teresopolis



Cameroon: Vitoria

Chile: Belo Horizonte

Cote Ivoire: Aguas de Lindoia

Colombia: Cotia

Costa Rica: Santos

Croatia: Mata de Sao Joao



Ecuador: Viamao

England: Rio de Janeiro



France: Ribeirao Preto



Germany: Santa Cruz Cabralia

Ghana: Maceio

Greece: Aracaju



Honduras: Porto Feliz



Italy: Mangaratiba

Iran: Guarulhos



Japan: Itu



Korea Republic: Foz do Iguacu

Mexico: Santos



Netherlands: Rio de Janeiro

Nigeria, Portugal: Campinas



Portugal: Campinas



Russia: Itu



Spain: Curitiba

Switzerland: Porto Seguro



Uruguay: Sete Lagoas

USA: Sao Paulo